111111111111111
10010000000C111
101001111100111
10001100C000111
100000C00010111
11001C00CE0P111
1C0000000C00111
111111111111111
