11111111111
1P0C0000011
10001E00001
10111000001
10000000001
1CCCCCCCCC1
11111111111
