1111111111
1P0011E001
100C00000C
1C00010001
1111111111
