11111111111
1PC00000001
10001E00001
10111000001
10000001001
1CCCCCCCCC1
11111111111
