11111111111
100C0000011
10001E00001
10111000001
1000000000P
1CCCCCCCCC1
11111111111
